             ######################################################             
            #                           |                          #            
           #                            |                           #           
          #                           1 |                            #          
         #                              |            *                #         
        #                             2 |                              #        
       #                                |                               #       
      #                                 |                                #      
      #              ######################################              #      
      #             #                                      #             #      
      #            #                                        #            #      
      #           #                                          #           #      
      #          #                                            #          #      
      #         #                                              #         #      
      #        #                                                #        #      
      #       #                                                  #       #      
      #       #                                                  #       #      
      #       #                                                  #       #      
      #       #                                                  #       #      
      #       #                                                  #       #      
      #       #                                                  #       #      
      #       #                                                  #       #      
      #       #                                                  #       #      
      #       #                                                  #       #      
      #       #                                                  #       #      
      #       #                                                  #       #      
      #       #                                                  #       #      
      #       #                                                  #       #      
      #       #                                                  #       #      
      #       #                                                  #       #      
      #       #                                                  #       #      
      #       #                                                  #       #      
      #       #                                                  #       #      
      #       #                                                  #       #      
      #       #                                                  #       #      
      #       #                                                  #       #      
      #       #                                                  #       #      
      #        #                                                #        #      
      #         #                                              #         #      
      #          #                                            #          #      
      #           #                                          #           #      
      #            #                                        #            #      
      #             #                                      #             #      
      #              ######################################              #      
      #                                                                  #      
       #                                                                #       
        #                                                              #        
         #                              +                             #         
          #                                                          #          
           #                                                        #           
            #                                                      #            
             ######################################################